6 10
|--------|
|...|....|
|........|
|....@.|.|
|........|
|--------|
